//MAP CONVERTED BY dmm2tgm.py THIS HEADER COMMENT PREVENTS RECONVERSION, DO NOT REMOVE
"a" = (
/turf/closed/wall/mineral/decowood,
/area/indoors/town/rmh)
"b" = (
/turf/closed/wall/mineral/roofwall/outercorner{
	dir = 8
	},
/area/indoors/town/rmh)
"c" = (
/obj/machinery/light/fueled/wallfire/candle/l{
	pixel_y = -32
	},
/turf/open/floor/ruinedwood/spiral,
/area/indoors/town/rmh)
"d" = (
/obj/structure/fluff/railing/wood/east,
/turf/open/floor/twig,
/area/indoors/town/rmh)
"e" = (
/obj/structure/ladder,
/turf/open/floor/ruinedwood/spiral,
/area/indoors/town/rmh)
"f" = (
/turf/closed/wall/mineral/roofwall/middle,
/area/indoors/town/rmh)
"g" = (
/obj/structure/window/openclose/reinforced{
	dir = 1
	},
/obj/structure/fluff/railing/border/west,
/obj/structure/fluff/railing/border/east,
/turf/open/floor/ruinedwood,
/area/indoors/town/rmh)
"h" = (
/turf/closed/wall/mineral/wooddark/vertical,
/area/indoors/town/rmh)
"j" = (
/obj/item/key{
	lockids = list("housingcellar1")
	},
/turf/open/floor/ruinedwood/spiral,
/area/indoors/town/rmh)
"m" = (
/turf/closed/wall/mineral/roofwall/middle{
	dir = 1
	},
/area/indoors/town/rmh)
"p" = (
/obj/effect/decal/edge_corner{
	dir = 8;
	color = "#522f26";
	pixel_y = 0
	},
/obj/effect/decal/edge{
	dir = 4;
	color = "#522f26"
	},
/turf/open/floor/tile/brick,
/area/indoors/town/rmh)
"s" = (
/turf/closed/wall/mineral/craftstone,
/area/outdoors/rmh_air)
"u" = (
/turf/closed/wall/mineral/roofwall/middle{
	dir = 4
	},
/area/indoors/town/rmh)
"x" = (
/obj/structure/window/openclose/reinforced{
	dir = 2
	},
/obj/structure/fluff/railing/border/west,
/obj/structure/fluff/railing/border/east,
/turf/open/floor/ruinedwood,
/area/indoors/town/rmh)
"y" = (
/turf/closed/wall/mineral/craftstone,
/area/indoors/town/rmh)
"z" = (
/obj/effect/decal/edge_corner{
	dir = 2;
	color = "#522f26";
	pixel_y = 0
	},
/obj/effect/decal/edge{
	dir = 5;
	color = "#522f26"
	},
/turf/open/floor/tile/brick,
/area/indoors/town/rmh)
"A" = (
/obj/structure/sign/property_sign/claim,
/turf/closed/wall/mineral/wooddark/vertical,
/area/indoors/town/rmh)
"B" = (
/obj/machinery/light/fueled/wallfire/candle/r{
	pixel_y = -32
	},
/turf/open/floor/ruinedwood/spiral,
/area/indoors/town/rmh)
"C" = (
/obj/structure/door{
	lockid = "housing3";
	name = "C-House III"
	},
/turf/open/floor/ruinedwood/darker,
/area/indoors/town/rmh)
"D" = (
/obj/structure/ladder,
/turf/open/floor/twig,
/area/indoors/town/rmh)
"F" = (
/turf/closed/wall/mineral/wooddark,
/area/indoors/town/rmh)
"G" = (
/obj/structure/window/openclose/reinforced{
	dir = 1
	},
/obj/structure/curtain/dir{
	dir = 1;
	color = "#8a6b6b"
	},
/turf/open/floor/ruinedwood,
/area/indoors/town/rmh)
"H" = (
/turf/open/floor/rooftop{
	dir = 1
	},
/area/outdoors/rmh_air)
"J" = (
/obj/effect/decal/edge_corner{
	dir = 4;
	color = "#522f26"
	},
/obj/effect/decal/edge{
	dir = 9;
	color = "#522f26"
	},
/turf/open/floor/tile/brick,
/area/indoors/town/rmh)
"K" = (
/obj/effect/decal/edge_corner{
	dir = 1;
	color = "#522f26";
	pixel_y = 0
	},
/obj/effect/decal/edge{
	dir = 8;
	color = "#522f26"
	},
/obj/machinery/light/fueled/wallfire/candle/r{
	pixel_y = 32
	},
/turf/open/floor/tile/brick,
/area/indoors/town/rmh)
"L" = (
/turf/closed/wall/mineral/roofwall/outercorner{
	dir = 1
	},
/area/indoors/town/rmh)
"N" = (
/turf/closed/wall/mineral/roofwall/outercorner,
/area/indoors/town/rmh)
"O" = (
/obj/machinery/light/fueled/wallfire/candle/l,
/turf/open/floor/ruinedwood/spiral,
/area/indoors/town/rmh)
"Q" = (
/turf/closed/wall/mineral/roofwall/outercorner{
	dir = 4
	},
/area/indoors/town/rmh)
"R" = (
/turf/open/floor/ruinedwood/spiral,
/area/indoors/town/rmh)
"S" = (
/turf/open/openspace,
/area/indoors/town/rmh)
"T" = (
/obj/effect/decal/edge{
	dir = 2;
	color = "#522f26"
	},
/obj/effect/decal/edge{
	dir = 1;
	color = "#522f26"
	},
/turf/open/floor/tile/brick,
/area/indoors/town/rmh)
"U" = (
/obj/structure/window/openclose/reinforced{
	dir = 2
	},
/obj/structure/curtain/dir{
	dir = 2;
	color = "#8a6b6b"
	},
/turf/open/floor/ruinedwood,
/area/indoors/town/rmh)
"V" = (
/obj/machinery/light/fueled/hearth,
/obj/machinery/light/fueled/oven/south,
/turf/open/floor/cobblerock,
/area/indoors/town/rmh)
"W" = (
/obj/machinery/light/fueled/wallfire/candle/l{
	pixel_y = 32
	},
/turf/open/floor/ruinedwood/spiral,
/area/indoors/town/rmh)
"X" = (
/turf/open/floor/twig,
/area/indoors/town/rmh)
"Y" = (
/turf/open/floor/rooftop,
/area/outdoors/rmh_air)
"Z" = (
/turf/closed/wall/mineral/roofwall/middle{
	dir = 8
	},
/area/indoors/town/rmh)

(1,1,1) = {"
F
a
a
F
a
a
F
"}
(2,1,1) = {"
a
W
R
h
e
c
a
"}
(3,1,1) = {"
U
R
R
F
R
R
G
"}
(4,1,1) = {"
y
p
z
O
R
R
a
"}
(5,1,1) = {"
y
V
T
R
R
R
G
"}
(6,1,1) = {"
y
K
J
j
R
B
a
"}
(7,1,1) = {"
F
a
A
C
h
a
F
"}

(1,1,2) = {"
H
N
Z
Z
Z
Q
Y
"}
(2,1,2) = {"
H
m
X
X
D
f
Y
"}
(3,1,2) = {"
H
m
X
X
X
f
Y
"}
(4,1,2) = {"
H
x
d
d
d
g
Y
"}
(5,1,2) = {"
s
m
S
S
S
f
Y
"}
(6,1,2) = {"
H
m
S
S
S
f
Y
"}
(7,1,2) = {"
H
L
u
u
u
b
Y
"}
