//MAP CONVERTED BY dmm2tgm.py THIS HEADER COMMENT PREVENTS RECONVERSION, DO NOT REMOVE
"a" = (
/turf/open/floor/woodturned,
/area/indoors/town/rmh)
"c" = (
/obj/structure/sign/property_sign/claim,
/turf/closed/wall/mineral/wooddark/vertical,
/area/indoors/town/rmh)
"e" = (
/turf/closed/wall/mineral/wooddark,
/area/indoors/town/rmh)
"j" = (
/turf/open/openspace,
/area/indoors/town/rmh)
"k" = (
/obj/structure/stairs/ccw{
	dir = 1
	},
/turf/open/floor/ruinedwood/alizeria/tiles/wood21,
/area/indoors/town/rmh)
"l" = (
/obj/structure/window/openclose/reinforced{
	dir = 2
	},
/obj/structure/curtain/dir{
	color = "#428138";
	dir = 1
	},
/turf/open/floor/wood,
/area/indoors/town/rmh)
"n" = (
/obj/structure/fluff/railing/wood,
/turf/open/floor/grass/healthy,
/area/indoors/town/rmh)
"r" = (
/turf/closed/wall/mineral/wooddark/vertical,
/area/indoors/town/rmh)
"t" = (
/turf/open/floor/wood,
/area/indoors/town/rmh)
"w" = (
/turf/open/floor/ruinedwood/alizeria/tiles/wood21,
/area/indoors/town/rmh)
"y" = (
/obj/structure/fluff/railing/border/north,
/turf/open/floor/ruinedwood/alizeria/tiles/wood21,
/area/indoors/town/rmh)
"L" = (
/obj/structure/fluff/railing/wood/east,
/turf/open/floor/grass/healthy,
/area/indoors/town/rmh)
"N" = (
/obj/structure/door{
	lockid = "housing7";
	name = "C-House VII"
	},
/turf/open/floor/ruinedwood/alizeria/tiles/wood21,
/area/indoors/town/rmh)
"R" = (
/obj/structure/stairs{
	dir = 4
	},
/turf/open/floor/ruinedwood/alizeria/tiles/wood21,
/area/indoors/town/rmh)
"V" = (
/turf/closed/wall/mineral/stone,
/area/indoors/town/rmh)
"W" = (
/obj/structure/fluff/railing/corner{
	dir = 9
	},
/turf/open/floor/ruinedwood/alizeria/tiles/wood21,
/area/indoors/town/rmh)

(1,1,1) = {"
V
V
V
V
V
V
V
"}
(2,1,1) = {"
V
k
t
t
a
a
V
"}
(3,1,1) = {"
V
e
t
t
a
a
V
"}
(4,1,1) = {"
V
t
t
t
a
a
V
"}
(5,1,1) = {"
V
a
a
a
a
a
V
"}
(6,1,1) = {"
V
a
a
a
a
a
V
"}
(7,1,1) = {"
V
V
V
V
V
V
V
"}

(1,1,2) = {"
V
V
V
V
V
V
V
"}
(2,1,2) = {"
r
j
y
w
w
w
V
"}
(3,1,2) = {"
r
R
y
w
w
w
V
"}
(4,1,2) = {"
l
w
W
w
w
w
V
"}
(5,1,2) = {"
r
w
w
w
w
w
V
"}
(6,1,2) = {"
V
e
w
w
w
e
V
"}
(7,1,2) = {"
L
V
c
N
r
V
n
"}
