//MAP CONVERTED BY dmm2tgm.py THIS HEADER COMMENT PREVENTS RECONVERSION, DO NOT REMOVE
"a" = (
/obj/machinery/light/fueled/wallfire/candle/r,
/turf/open/floor/ruinedwood/spiralfade,
/area/indoors/town/rmh)
"g" = (
/obj/machinery/light/fueled/wallfire/candle/r{
	pixel_y = 32
	},
/turf/open/floor/ruinedwood/spiralfade,
/area/indoors/town/rmh)
"m" = (
/obj/machinery/light/fueled/hearth,
/obj/item/reagent_containers/glass/bucket/pot,
/obj/machinery/light/fueled/oven/south,
/turf/open/floor/cobblerock,
/area/indoors/town/rmh)
"p" = (
/obj/machinery/light/fueled/wallfire/candle/l{
	pixel_y = -32
	},
/turf/open/floor/ruinedwood/spiralfade,
/area/indoors/town/rmh)
"r" = (
/obj/item/key{
	lockids = list("housingcellar1")
	},
/turf/open/floor/ruinedwood/spiralfade,
/area/indoors/town/rmh)
"s" = (
/turf/closed/wall/mineral/wooddark/vertical,
/area/indoors/town/rmh)
"u" = (
/obj/machinery/light/fueled/wallfire/candle/r{
	pixel_y = -32
	},
/turf/open/floor/ruinedwood/spiralfade,
/area/indoors/town/rmh)
"y" = (
/obj/effect/decal/edge_corner{
	dir = 4;
	color = "#522f26"
	},
/turf/open/floor/blocks/stonered,
/area/indoors/town/rmh)
"A" = (
/obj/structure/door{
	lockid = "housing4";
	name = "C-House IV"
	},
/turf/open/floor/cobblerock,
/area/indoors/town/rmh)
"C" = (
/turf/closed/wall/mineral/craftstone,
/area/indoors/town/rmh)
"E" = (
/obj/structure/sign/property_sign/claim,
/turf/closed/wall/mineral/stone,
/area/indoors/town/rmh)
"G" = (
/obj/effect/decal/edge_corner{
	dir = 2;
	color = "#522f26";
	pixel_y = 0
	},
/turf/open/floor/blocks/stonered,
/area/indoors/town/rmh)
"H" = (
/turf/closed/wall/mineral/wooddark/horizontal,
/area/indoors/town/rmh)
"L" = (
/turf/closed/wall/mineral/stone,
/area/indoors/town/rmh)
"N" = (
/obj/effect/decal/edge{
	dir = 2;
	color = "#522f26"
	},
/turf/open/floor/blocks/stonered,
/area/indoors/town/rmh)
"O" = (
/obj/structure/window/openclose/reinforced{
	dir = 4
	},
/obj/structure/curtain/dir{
	dir = 4;
	color = "#8a6b6b"
	},
/turf/open/floor/woodturned,
/area/indoors/town/rmh)
"U" = (
/turf/closed/wall/mineral/wooddark,
/area/indoors/town/rmh)
"X" = (
/turf/open/floor/ruinedwood/spiralfade,
/area/indoors/town/rmh)
"Z" = (
/obj/machinery/light/fueled/wallfire/candle/l{
	pixel_y = 32
	},
/turf/open/floor/ruinedwood/spiralfade,
/area/indoors/town/rmh)

(1,1,1) = {"
U
L
O
L
U
H
H
U
"}
(2,1,1) = {"
L
Z
X
X
X
Z
p
s
"}
(3,1,1) = {"
C
G
X
X
X
X
X
s
"}
(4,1,1) = {"
m
N
X
X
X
X
X
U
"}
(5,1,1) = {"
C
y
X
X
X
X
X
L
"}
(6,1,1) = {"
L
g
X
X
a
r
u
L
"}
(7,1,1) = {"
U
L
L
L
U
A
E
U
"}
