//MAP CONVERTED BY dmm2tgm.py THIS HEADER COMMENT PREVENTS RECONVERSION, DO NOT REMOVE
"a" = (
/turf/closed/wall/mineral/wood,
/area/indoors/town/rmh)
"e" = (
/obj/structure/fluff/railing/border/west,
/turf/open/floor/ruinedwood/alizeria/tiles/wood19,
/area/indoors/town/rmh)
"f" = (
/turf/open/floor/ruinedwood/alizeria/tiles/wood19,
/area/indoors/town/rmh)
"l" = (
/obj/structure/sign/property_sign/claim,
/turf/closed/wall/mineral/wooddark/horizontal,
/area/indoors/town/rmh)
"m" = (
/obj/structure/fluff/railing/corner/south_east,
/turf/open/floor/ruinedwood/alizeria/tiles/wood19,
/area/indoors/town/rmh)
"q" = (
/turf/open/openspace,
/area/indoors/town/rmh)
"v" = (
/obj/structure/window/openclose/reinforced{
	dir = 8
	},
/obj/structure/curtain/green,
/turf/open/floor/wood,
/area/indoors/town/rmh)
"w" = (
/obj/structure/stairs{
	dir = 8
	},
/turf/open/floor/ruinedwood/alizeria/tiles/wood19,
/area/indoors/town/rmh)
"C" = (
/obj/structure/window/solid,
/obj/structure/curtain/green,
/turf/open/floor/wood,
/area/indoors/town/rmh)
"F" = (
/obj/structure/door{
	lockid = "housing5";
	name = "C-House V"
	},
/turf/open/floor/ruinedwood/alizeria/tiles/wood19,
/area/indoors/town/rmh)
"G" = (
/obj/structure/fluff/railing/border/east,
/turf/open/floor/ruinedwood/alizeria/tiles/wood19,
/area/indoors/town/rmh)
"I" = (
/obj/structure/fluff/railing/corner/south_west,
/turf/open/floor/ruinedwood/alizeria/tiles/wood19,
/area/indoors/town/rmh)
"J" = (
/turf/closed/wall/mineral/wooddark/horizontal,
/area/indoors/town/rmh)
"P" = (
/obj/structure/window/openclose/reinforced{
	dir = 1
	},
/obj/structure/curtain/green,
/turf/open/floor/wood,
/area/indoors/town/rmh)
"R" = (
/obj/structure/fluff/railing/corner,
/turf/open/floor/ruinedwood/alizeria/tiles/wood19,
/area/indoors/town/rmh)
"S" = (
/turf/closed/wall/mineral/wooddark,
/area/indoors/town/rmh)
"T" = (
/obj/structure/window/openclose/reinforced{
	dir = 2
	},
/obj/structure/curtain/green,
/turf/open/floor/wood,
/area/indoors/town/rmh)
"V" = (
/turf/closed/wall/mineral/wooddark/vertical,
/area/indoors/town/rmh)

(1,1,1) = {"
S
J
J
J
J
J
S
"}
(2,1,1) = {"
V
f
f
f
m
G
V
"}
(3,1,1) = {"
V
f
f
f
R
w
l
"}
(4,1,1) = {"
V
f
f
f
f
f
F
"}
(5,1,1) = {"
V
f
f
f
f
f
J
"}
(6,1,1) = {"
V
f
f
f
f
f
V
"}
(7,1,1) = {"
S
J
J
J
J
J
S
"}

(1,1,2) = {"
S
a
a
a
a
a
S
"}
(2,1,2) = {"
a
f
f
f
m
w
a
"}
(3,1,2) = {"
T
f
f
f
R
q
C
"}
(4,1,2) = {"
a
a
a
S
I
e
a
"}
(5,1,2) = {"
T
f
f
a
f
f
P
"}
(6,1,2) = {"
a
f
f
f
f
f
a
"}
(7,1,2) = {"
S
a
a
a
v
a
S
"}
