//MAP CONVERTED BY dmm2tgm.py THIS HEADER COMMENT PREVENTS RECONVERSION, DO NOT REMOVE
"a" = (
/obj/structure/redstone/repeater{
	dir = 2
	},
/turf/open/floor/desert/citybrick/citybrick1,
/area)
"d" = (
/obj/structure/redstone/pressure_plate,
/turf/open/floor/desert/citybrick/citybrick1,
/area)
"f" = (
/obj/structure/lever{
	redstone_id = "pyramidenter"
	},
/turf/open/floor/desert/citybrick/citybrick1,
/area)
"p" = (
/obj/structure/redstone/repeater{
	dir = 4
	},
/turf/open/floor/desert/citybrick/citybrick1,
/area)
"x" = (
/obj/structure/redstone/torch,
/turf/open/floor/desert/citybrick/citybrick1,
/area)
"A" = (
/obj/structure/redstone/repeater{
	dir = 8
	},
/turf/open/floor/desert/citybrick/citybrick1,
/area)
"D" = (
/obj/structure/door/desertdoorperm,
/turf/open/floor/tile/checkeralt,
/area)
"E" = (
/obj/structure/redstone/dust,
/turf/open/floor/desert/citybrick/citybrick1,
/area)
"L" = (
/turf/open/floor/desert/citybrick/citybrick1,
/area)
"N" = (
/obj/structure/bars/passage,
/turf/open/floor/metal,
/area)
"S" = (
/turf/closed/wall/mineral/desert_soapstone,
/area)
"Y" = (
/turf/closed/wall/mineral/desert_sandstone,
/area)

(1,1,1) = {"
L
L
L
L
L
L
L
L
L
L
L
L
L
L
L
L
L
L
L
S
L
L
L
"}
(2,1,1) = {"
L
L
d
L
d
L
L
L
L
L
L
L
L
L
L
L
L
L
L
D
L
L
L
"}
(3,1,1) = {"
L
L
A
L
A
L
L
L
L
L
L
L
L
L
L
L
L
L
L
S
L
L
L
"}
(4,1,1) = {"
L
L
Y
L
Y
L
L
L
L
L
L
L
L
L
L
L
L
L
L
Y
S
D
S
"}
(5,1,1) = {"
L
E
x
E
x
E
L
L
L
Y
Y
Y
Y
Y
L
L
L
L
L
L
L
L
L
"}
(6,1,1) = {"
L
A
L
A
L
A
L
L
L
Y
L
L
L
Y
L
L
L
L
L
L
L
L
L
"}
(7,1,1) = {"
L
E
L
Y
L
E
L
L
L
Y
L
f
L
Y
L
L
L
L
L
L
L
d
L
"}
(8,1,1) = {"
L
E
E
x
E
E
L
L
L
Y
L
L
L
Y
L
L
L
L
L
L
L
E
L
"}
(9,1,1) = {"
L
L
A
L
A
L
L
L
L
Y
Y
N
Y
Y
L
L
L
L
L
L
L
E
L
"}
(10,1,1) = {"
L
L
Y
L
Y
L
L
L
L
L
L
p
L
L
L
L
L
L
L
L
L
E
L
"}
(11,1,1) = {"
L
L
x
E
x
L
L
L
L
L
L
x
L
L
L
L
L
L
d
L
L
E
L
"}
(12,1,1) = {"
L
L
L
E
L
L
L
L
L
L
L
Y
L
L
L
L
L
L
A
L
L
E
L
"}
(13,1,1) = {"
L
L
E
E
L
L
L
L
L
L
L
p
L
L
L
L
L
L
Y
x
a
A
L
"}
(14,1,1) = {"
L
L
E
L
L
L
L
L
E
E
E
E
E
E
E
L
L
L
L
L
L
E
L
"}
(15,1,1) = {"
L
L
Y
L
L
L
L
L
x
E
x
E
x
E
x
L
L
L
L
L
L
E
L
"}
(16,1,1) = {"
L
L
x
L
L
L
L
L
Y
L
Y
L
Y
L
Y
E
E
E
E
E
E
E
L
"}
(17,1,1) = {"
L
L
A
L
L
L
L
L
E
L
E
L
E
L
L
L
L
L
L
L
L
L
L
"}
(18,1,1) = {"
d
E
a
E
E
Y
x
L
E
L
E
L
E
E
E
E
E
E
E
E
L
L
L
"}
(19,1,1) = {"
L
L
p
L
L
L
E
a
p
L
E
L
L
L
L
L
L
L
L
E
L
L
L
"}
(20,1,1) = {"
L
L
x
L
L
L
L
L
E
L
E
L
L
L
L
L
L
L
L
d
L
L
L
"}
(21,1,1) = {"
L
L
Y
L
L
L
L
L
d
L
E
E
E
E
E
E
d
L
L
E
L
L
L
"}
(22,1,1) = {"
L
L
E
L
L
L
L
L
L
L
L
L
L
L
E
L
L
L
L
E
L
L
L
"}
(23,1,1) = {"
L
L
E
E
E
E
E
E
E
E
d
L
L
L
E
x
Y
E
E
E
L
L
L
"}
